Thriller - Michael Jackson
Billie Jean - Michael Jackson
I Will Always Love You - Whitney Houston
Call Me Maybe - Carly Rae Jepsen
I Want It that Way - Backstreet Boys
Bad - Michael Jackson
Purple Rain - Prince
Party In the U.S.A. - Miley Cyrus
Firework - Katy Perry
We are Young - Fun.
The Middle - Zedd
In My Blood - Shawn Mendes
Beat It - Michael Jackson
Tonight - Enrique Iglesias
Give Me Everything - Pitbull
Like a Prayer - Madonna
Problem - Ariana Grande
The Winner Takes It All - ABBA
Girlfriend - Avril Lavigne
Gangnam Style - PSY
Written In the Stars - Tinie Tempah
Angels - Robbie Williams
Uptown Funk - Mark Ronson
Fancy - Iggy Azalea
Toxic - Britney Spears
Smooth Criminal - Michael Jackson
Someone Like You - Adele
We Found Love - Rihanna
Counting Stars - One Republic
Mirrors - Justin Timberlake
She Will Be Loved - Maroon 5
Crazy in Love - Beyonce
I Wanna Go - Britney Spears
Titanium - David Guetta
Poker Face - Lady Gaga
Listen to Your Heart - Roxette
My All - Mariah Carey
Hollaback Girl - Gwen Stefani
Scarface (Push It to the Limit) - Paul Engemann
Song to the Siren - This Mortal Coil
Please Don't Go - Mike Posner
Good Life - Onerepublic
God Only Knows - The Beach Boys
Wuthering Heights - Kate Bush
All of Me - John Legend
... Baby One More Time - Britney Spears
4 in the Morning - Gwen Stefani
Hungry Like the Wolf - Duran Duran
Hips Don't Lie - Shakira
Naturally - Selena Gomez
Shape of You - Ed Sheeran
Stayin' Alive - The Bee Gees
